Species,Start,End,Length,Category,Contig,Identifier
MAB,459147,493141,33994,4,1,CF00038-00414
MAB,236613,285911,49298,4,6,CF00135-00139
MMAS,22,31079,31057,4,10,CF00024-00056
MAB,0,33955,33955,4,13,CF00141-00144
MAB,61695,89451,27756,4,20,CF00055-00431
MINT,910,28289,27379,4,24,CF00004-00018
MAB,530706,574095,43389,5,1,CF00103-00108
MAB,477527,574095,96568,5,1,CF00103-00108
MAB,343423,389383,45960,5,1,CF00103-00108
MAB,469531,517225,47694,5,1,CF00143-00146
MAB,474780,516093,41313,5,1,CF00096-00101
MAB,468165,507804,39639,5,2,CF00120-00124
MMAS,112855,176603,63748,5,2,CF00206-00449
MAB,25576,71484,45908,5,2,CF00040-00180
MAB,469911,502722,32811,5,3,CF00103-00108
MBOL,86190,136097,49907,5,1,CF00020-00045
MBOL,56206,136097,79891,5,1,CF00020-00045
MBOL,370721,418385,47664,5,1,CF00765-00647
MMAS,295323,362204,66881,5,1,CF00035-00411
MMAS,290416,362204,71788,5,1,CF00035-00411
MAB,0,15503,15503,5,2,CF00788-00688
MAB,40468,97053,56585,5,2,CF00788-00688
MMAS,424961,475868,50907,5,3,CF00156-00158
MMAS,424944,475865,50921,5,2,CF00046-00423
MAB,239518,317962,78444,5,2,CF00171-00172
MAB,242,29385,29143,5,2,CF00118-00122
MMAS,368551,419479,50928,5,2,CF00198-00463
MAB,255,32484,32229,5,2,CF00142-00145
MAB,71285,112901,41616,5,1,CF00167-00168
MINT,264142,322572,58430,5,2,CF00079-00228
MINT,173584,225200,51616,5,2,CF00079-00228
MAB,126629,203558,76929,5,1,CF00031-00407
MAB,223863,271560,47697,5,3,CF00065-00440
MAB,299176,329003,29827,5,5,CF00080-00085
MAB,22143,66160,44017,5,6,CF00080-00085
MAB,70657,119129,48472,5,3,CF00764-00646
MMAS,290542,324109,33567,5,5,CF00316-00499
MAB,1758,65104,63346,5,4,CF00211-00454
MAB,49222,71470,22248,5,4,CF00280-00677
MAB,74316,134423,60107,5,3,CF00045-00421
MAB,0,53405,53405,5,4,CF00208-00451
MINT,153855,240504,86649,5,1,CF00007-00024
MAB,0,48028,48028,5,2,CF00053-00404
MMAS,0,52178,52178,5,5,CF00008-00026
MAB,235711,279379,43668,5,4,CF00154-00156
MAB,230963,272299,41336,5,4,CF00783-00676
MAB,6153,25141,18988,5,5,CF00107-00704
MAB,0,12516,12516,5,2,CF00108-00112
MAB,186831,239717,52886,5,5,CF00788-00688
MAB,55631,112943,57312,5,8,CF00783-00676
MMAS,48107,129106,80999,5,9,CF00170-00171
MAB,113995,180346,66351,5,6,CF00043-00419
MMAS,109723,178989,69266,5,6,CF00086-00091
MAB,144667,171066,26399,5,4,CF00151-00153
MAB,65282,146174,80892,5,7,CF00138-00141
MAB,150448,161001,10553,5,1,CF00261-00765
MAB,107641,151950,44309,5,4,CF00123-00127
MAB,94620,142314,47694,5,7,CF00066-00705
MAB,64052,111749,47697,5,9,CF00055-00431
MINT,50872,69180,18308,5,6,CF00087-00092
MMAS,113791,195246,81455,5,11,CF00001-00005
MAB,1393,129018,127625,5,4,CF00152-00154
MAB,161567,188720,27153,5,10,CF00026-00061
MAB,39111,83301,44190,5,8,CF00107-00704
MAB,0,52687,52687,5,8,CF00039-00415
MAB,67756,111671,43915,5,11,CF00044-00420
MAV,15294,72614,57320,5,5,CF00002-00012
MMAS,134034,176197,42163,5,7,CF00091-00096
MAB,125160,140757,15597,5,10,CF00795-00699
MAB,84753,167888,83135,5,6,CF00108-00112
MAB,125307,164378,39071,5,9,CF00017-00040
MMAS,2,42165,42163,5,14,CF00766-00648
MMAS,17,42180,42163,5,14,CF00316-00499
MAB,69992,146300,76308,5,12,CF00158-00160
MAB,69991,146299,76308,5,11,CF00142-00145
MAB,0,45314,45314,5,13,CF00308-00653
MAB,468,47730,47262,5,12,CF00280-00677
MAB,76259,127241,50982,5,12,CF00280-00677
MAB,74478,128445,53967,5,12,CF00280-00677
MMAS,115348,151840,36492,5,11,CF00035-00411
MCHIM,4502,64859,60357,5,8,CF00002-00014
MMAS,10,30222,30212,5,16,CF00193-00178
MAB,0,80231,80231,5,13,CF00067-00436
MAB,65250,145530,80280,5,14,CF00144-00147
MAB,0,80231,80231,5,14,CF00158-00160
MAB,65552,142479,76927,5,12,CF00143-00146
MAB,65552,109029,43477,5,12,CF00143-00146
MINT,17391,28890,11499,5,6,CF00092-00097
MMAS,9,41941,41932,5,17,CF00042-00418
MAB,248,8671,8423,5,14,CF00076-00179
MAB,0,43158,43158,5,10,CF00039-00415
MMAS,34287,72688,38401,5,13,CF00054-00430
MMAS,1241,72688,71447,5,13,CF00054-00430
MAB,0,41691,41691,5,11,CF00064-00439
MAB,0,39590,39590,5,11,CF00023-00438
MAB,9472,21631,12159,5,16,CF00048-00425
MAB,72905,131212,58307,5,16,CF00048-00425
MAB,72878,131185,58307,5,15,CF00006-00020
MAB,9444,21603,12159,5,15,CF00006-00020
MINT,54634,70111,15477,5,14,CF00007-00024
MAB,76077,127720,51643,5,11,CF00297-01032
MAB,25576,71483,45907,5,13,CF00030-00406
MAB,10545,59017,48472,5,18,CF00045-00421
MAB,8886,62628,53742,5,14,CF00040-00180
MINT,59865,75778,15913,5,15,CF00119-00123
MMAS,83617,118601,34984,5,7,CF00056-00432
MAB,76104,110352,34248,5,18,CF00123-00127
MAB,22143,66160,44017,5,17,CF00116-00120
MAB,58770,107164,48394,5,19,CF00097-00102
MAB,58776,107170,48394,5,18,CF00135-00139
MAB,0,48393,48393,5,18,CF00090-00095
MAB,58768,107162,48394,5,22,CF00148-00210
MAB,58751,107120,48369,5,16,CF00160-00161
MAB,58764,107117,48353,5,20,CF00034-00410
MAB,0,48358,48358,5,19,CF00118-00122
MAB,65250,104502,39252,5,16,CF00149-00151
MAB,11230,75839,64609,5,20,CF00064-00439
MMAS,56764,103664,46900,5,22,CF00035-00411
MMAS,71296,103664,32368,5,22,CF00035-00411
MAB,90,33681,33591,5,22,CF00134-00138
MINT,39000,52483,13483,5,19,CF00007-00024
MAV,0,8257,8257,5,14,CF00026-00062
MAV,0,8257,8257,5,13,CF00002-00012
MAV,0,8257,8257,5,12,CF00058-00099
MAV,0,8257,8257,5,17,CF00358-01030
MINT,48353,61954,13601,5,14,CF00087-00092
MBOL,43062,96304,53242,5,16,CF00113-00117
MAB,8854,63973,55119,5,19,CF00038-00414
MAV,4503,63319,58816,5,8,CF00146-00149
MAB,0,37189,37189,5,20,CF00795-00699
MAB,61091,91256,30165,5,23,CF00108-00112
MBOL,65300,91075,25775,5,21,CF00765-00647
MAB,2223,52338,50115,5,20,CF00026-00061
MAB,65552,88520,22968,5,20,CF00788-00688
MBOL,67,18090,18023,5,22,CF00765-00647
MINT,36442,55088,18646,5,25,CF00084-00089
MMAS,28763,83706,54943,5,24,CF00148-00208
MMAS,0,54188,54188,5,24,CF00054-00430
MAB,68354,82119,13765,5,22,CF00026-00061
MINT,19667,30124,10457,5,26,CF00073-00222
MAB,40085,53391,13306,5,22,CF00141-00144
MAV,29722,47310,17588,5,21,CF00060-00174
MAV,31689,49277,17588,5,20,CF00193-00177
MAV,31686,49274,17588,5,17,CF00150-00152
MAV,31668,49256,17588,5,23,CF00358-01030
MAB,468,47730,47262,5,24,CF00068-00219
MAB,13875,72192,58317,5,28,CF00151-00153
MAB,0,55673,55673,5,28,CF00108-00112
MAB,22785,67936,45151,5,22,CF00023-00438
MINT,48365,71012,22647,5,31,CF00004-00018
MAB,0,13601,13601,5,21,CF00211-00454
MAB,0,45676,45676,5,26,CF00068-00219
MAB,0,44472,44472,5,26,CF00068-00219
MAB,57903,71087,13184,5,23,CF00171-00172
MAV,29678,47266,17588,5,24,CF00168-00169
MAB,16984,68543,51559,5,25,CF00764-00646
MAB,0,20640,20640,5,27,CF00068-00219
MAB,0,16813,16813,5,25,CF00023-00438
MINT,19740,34839,15099,5,32,CF00012-00032
MAB,14823,59975,45152,5,27,CF00120-00124
MAB,8407,47638,39231,5,30,CF00123-00127
MAB,3727,47638,43911,5,30,CF00123-00127
MMAS,18120,47759,29639,5,30,CF00054-00430
MAB,0,29542,29542,5,28,CF00788-00688
MAV,28283,54432,26149,5,39,CF00198-00657
MAB,27274,57347,30073,5,33,CF00141-00144
MAB,312,39383,39071,5,32,CF00032-00408
MAB,17606,54962,37356,5,33,CF00032-00408
MAB,46959,53154,6195,5,34,CF00108-00112
MAV,4677,20052,15375,5,39,CF00009-00029
MAB,0,16409,16409,5,32,CF00208-00451
MBOL,0,15861,15861,5,23,CF00113-00117
MINT,801,19447,18646,5,38,CF00007-00024
MAV,29678,47266,17588,5,41,CF00028-00067
MAV,782,18370,17588,5,37,CF00189-00372
MAV,29676,47264,17588,5,39,CF00011-00054
MAB,2157,30410,28253,5,34,CF00050-00429
MMAS,23576,44772,21196,5,35,CF00047-00424
MMAS,25255,40028,14773,5,34,CF00054-00430
MMAS,25255,40026,14771,5,36,CF00148-00208
MAB,21083,33954,12871,5,48,CF00141-00144
MAB,0,6151,6151,5,45,CF00064-00439
MAB,25571,31769,6198,5,47,CF00039-00415
MAB,11598,30531,18933,5,48,CF00039-00415
MBOL,0,6708,6708,5,36,CF00773-00659
MAV,1520,12050,10530,5,52,CF00198-00657
MMAS,0,16535,16535,5,32,CF00008-00026
MAB,12752,26595,13843,5,40,CF00055-00431
MAV,17196,24191,6995,5,62,CF00128-00132
MINT,3821,15033,11212,5,55,CF00098-00103
MINT,12000,23120,11120,5,62,CF00087-00092
MAV,4724,14043,9319,5,101,CF00062-00447
MAB,4125,10420,6295,5,46,CF00067-00436
MMAS,259986,330954,70968,6,1,CF00001-00005
MAB,281033,314692,33659,6,1,CF00207-00450
MMAS,541001,592391,51390,6,1,CF00086-00091
MMAS,116651,146716,30065,6,1,CF00206-00449
MAB,477527,498777,21250,6,1,CF00103-00108
MAB,334993,353493,18500,6,1,CF00152-00154
MMAS,202668,213487,10819,6,2,CF00024-00056
MAB,257398,270796,13398,6,1,CF00171-00172
MAB,272366,285764,13398,6,1,CF00026-00061
MMAS,220142,256899,36757,6,2,CF00053-00403
MMAS,472328,533221,60893,6,1,CF00766-00648
MAB,489869,500651,10782,6,1,CF00107-00704
MAB,407582,463738,56156,6,3,CF00023-00438
MAB,322915,461431,138516,6,2,CF00795-00699
MAB,176741,244190,67449,6,2,CF00118-00122
MAB,130353,146370,16017,6,3,CF00040-00180
MMAS,264116,325366,61250,6,1,CF00054-00430
MMAS,264116,325366,61250,6,1,CF00148-00208
MAB,221556,246342,24786,6,2,CF00043-00419
MMAS,7419,65391,57972,6,5,CF00206-00449
MMAS,387161,407952,20791,6,2,CF00091-00096
MAB,429,13515,13086,6,2,CF00157-00159
MAB,430,13533,13103,6,1,CF00097-00102
MMAS,0,60844,60844,6,3,CF00091-00096
MAB,257386,270784,13398,6,2,CF00211-00454
MMAS,46002,80269,34267,6,3,CF00049-00426
MMAS,255779,268747,12968,6,2,CF00008-00026
MMAS,263000,290258,27258,6,2,CF00316-00499
MAB,363500,376586,13086,6,1,CF00093-00098
MMAS,2469,62506,60037,6,4,CF00036-00412
MAB,255603,270982,15379,6,3,CF00033-00409
MAB,226110,239864,13754,6,5,CF00080-00085
MMAS,63573,106793,43220,6,5,CF00001-00005
MAB,162886,176668,13782,6,3,CF00143-00146
MAB,429,13250,12821,6,3,CF00143-00146
MAB,12456,28473,16017,6,2,CF00038-00414
MMAS,190157,204941,14784,6,4,CF00170-00171
MMAS,222762,245792,23030,6,4,CF00156-00158
MAB,285917,301934,16017,6,1,CF00037-00413
MMAS,14444,84362,69918,6,5,CF00170-00171
MAB,435,15936,15501,6,4,CF00144-00147
MAB,432,13535,13103,6,3,CF00135-00139
MAB,0,12701,12701,6,3,CF00154-00156
MAB,396,15897,15501,6,3,CF00160-00161
MAB,292745,305848,13103,6,2,CF00048-00425
MAB,217870,231141,13271,6,3,CF00034-00410
MAB,396,15897,15501,6,4,CF00041-00417
MAB,63491,90718,27227,6,5,CF00040-00180
MMAS,285722,297125,11403,6,3,CF00053-00403
MINT,133306,148685,15379,6,2,CF00139-00142
MMAS,219868,263088,43220,6,7,CF00036-00412
MAB,210298,239068,28770,6,5,CF00023-00438
MAB,235756,251446,15690,6,3,CF00043-00419
MAB,209872,238525,28653,6,4,CF00209-00452
MMAS,117437,275424,157987,6,4,CF00198-00463
MMAS,13120,49877,36757,6,4,CF00154-00213
MAB,0,90315,90315,6,5,CF00106-00110
MAB,32127,49046,16919,6,3,CF00138-00141
MMAS,3,88130,88127,6,6,CF00035-00411
MAB,216950,245726,28776,6,4,CF00207-00450
MMAS,172801,259951,87150,6,5,CF00054-00430
MAB,210306,251989,41683,6,4,CF00050-00429
MAB,433,15934,15501,6,4,CF00125-00129
MMAS,209876,247797,37921,6,8,CF00170-00171
MMAS,23772,108349,84577,6,6,CF00046-00423
MMAS,0,18292,18292,6,6,CF00046-00423
MAB,112732,148954,36222,6,8,CF00171-00172
MAB,112732,148581,35849,6,7,CF00006-00020
MAB,0,29262,29262,6,5,CF00120-00124
MAB,0,27739,27739,6,3,CF00297-01032
MAB,1031,25399,24368,6,3,CF00030-00406
MAB,209101,233469,24368,6,3,CF00013-00035
MAB,210286,231135,20849,6,3,CF00037-00413
MAB,61307,117031,55724,6,9,CF00080-00085
MAB,0,28660,28660,6,5,CF00068-00219
MAB,213623,228734,15111,6,4,CF00149-00151
MAB,45661,129058,83397,6,8,CF00096-00101
MAB,167233,180504,13271,6,6,CF00308-00653
MMAS,2496,13899,11403,6,7,CF00154-00213
MMAS,71504,94534,23030,6,3,CF00047-00424
MAB,206390,217266,10876,6,4,CF00032-00408
MMAS,111414,122141,10727,6,9,CF00008-00026
MAB,201469,210726,9257,6,7,CF00167-00168
MMAS,149101,209324,60223,6,8,CF00001-00005
MMAS,0,61331,61331,6,8,CF00001-00005
MMAS,69056,145214,76158,6,8,CF00001-00005
MAB,169433,208425,38992,6,8,CF00026-00061
MAB,64727,124293,59566,6,9,CF00026-00061
MAB,130369,149460,19091,6,5,CF00064-00439
MAB,130368,146385,16017,6,3,CF00141-00144
MAB,181817,197733,15916,6,8,CF00211-00454
MINT,148,14777,14629,6,5,CF00131-00203
MINT,183115,197744,14629,6,5,CF00074-00223
MAB,180589,196505,15916,6,11,CF00171-00172
MAB,0,38325,38325,6,9,CF00033-00409
MAB,164407,183971,19564,6,9,CF00158-00160
MAB,137995,169062,31067,6,9,CF00068-00219
MAB,137993,169060,31067,6,8,CF00280-00677
MAB,175202,190703,15501,6,10,CF00158-00160
MAB,177625,190417,12792,6,9,CF00090-00095
MAB,174624,190313,15689,6,9,CF00308-00653
MAB,435,13538,13103,6,10,CF00148-00210
MAB,174474,189975,15501,6,10,CF00067-00436
MAV,134761,171821,37060,6,5,CF00083-00088
MAB,0,12390,12390,6,9,CF00053-00404
MAB,156769,188720,31951,6,10,CF00026-00061
MAB,0,11946,11946,6,11,CF00026-00061
MAB,29474,65696,36222,6,8,CF00157-00159
MAB,148989,168553,19564,6,11,CF00308-00653
MAB,141881,176117,34236,6,5,CF00108-00112
MAB,32021,48305,16284,6,14,CF00138-00141
MMAS,58,77111,77053,6,8,CF00091-00096
MMAS,15995,74232,58237,6,8,CF00082-00087
MAB,14353,100173,85820,6,12,CF00308-00653
MAB,141040,157057,16017,6,3,CF00261-00765
MAB,62653,91720,29067,6,7,CF00152-00154
MAB,0,29627,29627,6,8,CF00064-00439
MMAS,3267,47567,44300,6,12,CF00156-00158
MMAS,1278,14175,12897,6,11,CF00766-00648
MMAS,150382,163279,12897,6,10,CF00091-00096
MMAS,0,20754,20754,6,12,CF00766-00648
MMAS,0,20744,20744,6,9,CF00042-00418
MMAS,143766,164542,20776,6,7,CF00035-00411
MMAS,3267,47567,44300,6,8,CF00047-00424
MAB,0,14261,14261,6,9,CF00066-00705
MMAS,2496,13899,11403,6,9,CF00121-00125
MBOL,116471,127607,11136,6,12,CF00113-00117
MAB,107684,125301,17617,6,12,CF00044-00420
MAB,11703,27720,16017,6,11,CF00013-00035
MAB,0,40085,40085,6,12,CF00013-00035
MMAS,0,60844,60844,6,11,CF00035-00411
MMAS,130550,143447,12897,6,15,CF00042-00418
MAB,0,41642,41642,6,10,CF00032-00408
MCHIM,0,32163,32163,6,11,CF00115-00119
MAB,120559,139645,19086,6,13,CF00013-00035
MAB,101705,131471,29766,6,9,CF00123-00127
MINT,54544,77954,23410,6,8,CF00025-00057
MAB,4749,49128,44379,6,17,CF00016-00037
MAB,115348,129715,14367,6,11,CF00123-00127
MAB,14354,80680,66326,6,13,CF00065-00440
MAB,14354,80680,66326,6,16,CF00142-00145
MAB,0,27717,27717,6,13,CF00152-00154
MAB,100394,128157,27763,6,14,CF00045-00421
MAB,5332,89385,84053,6,13,CF00064-00439
MAB,46277,59787,13510,6,13,CF00107-00704
MAB,98371,126114,27743,6,15,CF00138-00141
MAB,93056,125351,32295,6,13,CF00207-00450
MAB,93049,125344,32295,6,13,CF00135-00139
MAB,520,32815,32295,6,18,CF00125-00129
MAB,93046,125341,32295,6,16,CF00097-00102
MAB,11703,27720,16017,6,16,CF00076-00179
MAB,0,17227,17227,6,14,CF00107-00704
MAB,8500,24517,16017,6,11,CF00050-00429
MAV,18319,55379,37060,6,8,CF00027-00066
MINT,54145,72068,17923,6,12,CF00059-00445
MAB,715,21564,20849,6,14,CF00017-00040
MINT,48556,66137,17581,6,13,CF00132-00136
MAB,8092,27656,19564,6,14,CF00116-00120
MAB,8127,27691,19564,6,17,CF00783-00676
MAB,8105,27669,19564,6,15,CF00144-00147
MAB,93047,112611,19564,6,14,CF00114-00118
MAB,8103,28040,19937,6,16,CF00090-00095
MAB,93065,112629,19564,6,12,CF00080-00085
MAB,93056,112619,19563,6,15,CF00148-00210
MAB,93051,112615,19564,6,15,CF00143-00146
MAB,8105,27669,19564,6,13,CF00053-00404
MAB,8059,27623,19564,6,15,CF00118-00122
MAB,93046,112610,19564,6,15,CF00065-00440
MAB,93040,112604,19564,6,15,CF00066-00705
MAB,93027,112591,19564,6,17,CF00067-00436
MAB,8083,27649,19566,6,14,CF00034-00410
MAB,201,49620,49419,6,15,CF00030-00406
MAB,0,30369,30369,6,13,CF00103-00108
MAB,89620,118629,29009,6,15,CF00207-00450
MINT,50604,64890,14286,6,17,CF00012-00032
MINT,38791,62201,23410,6,12,CF00152-00469
MAB,27236,83377,56141,6,14,CF00120-00124
MAV,89255,115650,26395,6,13,CF00111-00115
MAV,393,18095,17702,6,13,CF00111-00115
MCHIM,27011,41197,14186,6,14,CF00770-00654
MAV,0,26864,26864,6,14,CF00127-00131
MAV,57433,110463,53030,6,14,CF00127-00131
MAB,87383,106947,19564,6,18,CF00048-00425
MAB,87363,106927,19564,6,18,CF00154-00156
MAB,0,57999,57999,6,15,CF00106-00110
MAB,93046,114729,21683,6,18,CF00134-00138
MAV,1567,48358,46791,6,11,CF00062-00447
MAB,14496,55637,41141,6,14,CF00764-00646
MAV,1215,17315,16100,6,5,CF00012-00435
MAV,27840,111048,83208,6,5,CF00012-00435
MAB,2169,46083,43914,6,18,CF00023-00438
MAB,2169,46083,43914,6,18,CF00120-00124
MAB,14511,66615,52104,6,19,CF00167-00168
MAB,67199,95975,28776,6,18,CF00114-00118
MAB,67182,95958,28776,6,16,CF00171-00172
MAB,14354,43130,28776,6,19,CF00134-00138
MAB,14354,43130,28776,6,17,CF00211-00454
MINT,56673,72948,16275,6,21,CF00012-00032
MMAS,66386,96140,29754,6,19,CF00148-00208
MINT,38926,56582,17656,6,15,CF00004-00018
MAB,63335,92112,28777,6,21,CF00138-00141
MCHIM,26879,44640,17761,6,14,CF00129-00133
MCHIM,26806,44567,17761,6,13,CF00194-00380
MCHIM,26790,44551,17761,6,16,CF00187-00369
MINT,29932,50393,20461,6,19,CF00025-00057
MAB,1036,81436,80400,6,18,CF00039-00415
MINT,20343,39714,19371,6,16,CF00073-00222
MAB,56776,102125,45349,6,17,CF00149-00151
MINT,62755,76974,14219,6,19,CF00084-00089
MMAS,0,25611,25611,6,17,CF00156-00158
MMAS,28731,100213,71482,6,17,CF00156-00158
MMAS,0,25614,25614,6,18,CF00198-00463
MMAS,28734,100216,71482,6,18,CF00198-00463
MMAS,532,13275,12743,6,18,CF00056-00432
MAB,47056,98948,51892,6,20,CF00040-00180
MAB,1352,28579,27227,6,22,CF00123-00127
MCHIM,26834,44595,17761,6,17,CF00155-00157
MMAS,17486,96803,79317,6,17,CF00082-00087
MBOL,51834,78622,26788,6,21,CF00773-00659
MAB,14354,43130,28776,6,22,CF00090-00095
MAB,14354,43130,28776,6,21,CF00135-00139
MAB,14354,43130,28776,6,19,CF00006-00020
MAB,48029,76805,28776,6,21,CF00143-00146
MAB,14354,43130,28776,6,14,CF00080-00085
MINT,8486,24510,16024,6,22,CF00105-00109
MAB,56711,90157,33446,6,22,CF00280-00677
MAV,18142,55192,37050,6,18,CF00198-00657
MAB,70168,87667,17499,6,22,CF00068-00219
MAB,0,17450,17450,6,24,CF00280-00677
MCHIM,76029,86372,10343,6,25,CF00155-00157
MAV,59190,85696,26506,6,18,CF00193-00177
MAV,879,27385,26506,6,12,CF00146-00149
MAB,12789,31880,19091,6,22,CF00106-00110
MCHIM,8089,22696,14607,6,19,CF00020-00046
MAB,44067,71282,27215,6,24,CF00783-00676
MBOL,63807,84021,20214,6,18,CF00113-00117
MAB,36969,77950,40981,6,23,CF00297-01032
MMAS,0,23300,23300,6,25,CF00054-00430
MMAS,74,14211,14137,6,26,CF00766-00648
MAV,0,14246,14246,6,23,CF00164-00165
MMAS,14160,24335,10175,6,21,CF00047-00424
MMAS,56410,66537,10127,6,17,CF00046-00423
MAB,52881,68898,16017,6,26,CF00030-00406
MAB,0,22206,22206,6,24,CF00158-00160
MAB,0,22206,22206,6,23,CF00055-00431
MAV,0,58683,58683,6,25,CF00141-00206
MAB,47,30420,30373,6,20,CF00103-00108
MINT,35388,45843,10455,6,27,CF00059-00445
MAB,52930,68947,16017,6,26,CF00167-00168
MMAS,24998,53207,28209,6,26,CF00148-00208
MMAS,69957,78357,8400,6,26,CF00148-00208
MAB,18963,46381,27418,6,28,CF00039-00415
MMAS,0,5326,5326,6,19,CF00046-00423
MMAS,0,5326,5326,6,22,CF00198-00463
MAB,50064,69628,19564,6,24,CF00149-00151
MAV,40416,72349,31933,6,26,CF00052-00071
MBOL,49727,71503,21776,6,24,CF00773-00659
MBOL,5569,37467,31898,6,24,CF00765-00647
MAB,27143,55919,28776,6,28,CF00208-00451
MCHIM,56481,69685,13204,6,34,CF00155-00157
MAB,14354,43130,28776,6,24,CF00788-00688
MAB,0,23409,23409,6,27,CF00031-00407
MAB,14354,43130,28776,6,28,CF00041-00417
MAB,7926,20592,12666,6,29,CF00038-00414
MAB,0,49548,49548,6,30,CF00038-00414
MAB,14354,57441,43087,6,22,CF00103-00108
MAB,44073,63750,19677,6,30,CF00108-00112
MBOL,11419,33750,22331,6,25,CF00020-00045
MAB,36347,60715,24368,6,30,CF00031-00407
MINT,10023,22624,12601,6,27,CF00098-00103
MAV,0,35085,35085,6,34,CF00358-01030
MINT,975,12506,11531,6,31,CF00074-00223
MAV,0,12704,12704,6,35,CF00358-01030
MAV,0,12716,12716,6,4,CF00008-00396
MINT,19937,40157,20220,6,32,CF00145-00148
MINT,19937,40157,20220,6,32,CF00107-00111
MAB,37951,59583,21632,6,30,CF00017-00040
MBOL,51511,59348,7837,6,21,CF00113-00117
MAB,0,33397,33397,6,33,CF00068-00219
MAB,566,13889,13323,6,33,CF00152-00154
MAV,35920,53067,17147,6,36,CF00057-00443
MCHIM,0,40483,40483,6,42,CF00187-00369
MAB,503,12997,12494,6,36,CF00152-00154
MMAS,25442,49303,23861,6,29,CF00082-00087
MAV,19053,37109,18056,6,40,CF00127-00131
MMAS,18227,30066,11839,6,20,CF00024-00056
MAB,7339,34566,27227,6,27,CF00016-00037
MAB,11060,48996,37936,6,32,CF00065-00440
MAV,26332,46723,20391,6,38,CF00778-00668
MINT,5527,40023,34496,6,39,CF00012-00032
MAV,15367,47674,32307,6,9,CF00008-00396
MBOL,0,30451,30451,6,28,CF00765-00647
MCHIM,27011,41179,14168,6,43,CF00155-00157
MAB,0,19779,19779,6,35,CF00037-00413
MCHIM,10725,44689,33964,6,49,CF00187-00369
MCHIM,0,33872,33872,6,47,CF00129-00133
MAB,14354,43720,29366,6,39,CF00097-00102
MAB,14354,43711,29357,6,31,CF00048-00425
MAB,0,29285,29285,6,31,CF00125-00129
MAB,14354,43684,29330,6,35,CF00154-00156
MAB,0,29275,29275,6,34,CF00093-00098
MAB,0,29268,29268,6,34,CF00066-00705
MAB,0,29266,29266,6,34,CF00116-00120
MAB,14354,43666,29312,6,34,CF00148-00210
MAB,14354,43663,29309,6,33,CF00160-00161
MAB,0,29262,29262,6,33,CF00157-00159
MAB,14354,43654,29300,6,34,CF00149-00151
MAB,21065,43372,22307,6,36,CF00037-00413
MAB,119,11558,11439,6,39,CF00039-00415
MCHIM,20189,38544,18355,6,45,CF00155-00157
MAB,22086,43078,20992,6,40,CF00261-00765
MAB,0,28662,28662,6,31,CF00026-00061
MAB,14511,42364,27853,6,32,CF00106-00110
MAB,14511,42262,27751,6,41,CF00141-00144
MAB,0,27717,27717,6,31,CF00096-00101
MAB,14342,42055,27713,6,32,CF00130-00134
MAV,64,21678,21614,6,43,CF00127-00131
MAB,7043,37272,30229,6,40,CF00039-00415
MAV,2850,24753,21903,6,42,CF00164-00165
MAB,0,14758,14758,6,42,CF00031-00407
MCHIM,13752,39653,25901,6,47,CF00155-00157
MAB,12785,32722,19937,6,35,CF00786-00686
MAB,284,18661,18377,6,44,CF00031-00407
MMAS,32595,38685,6090,6,24,CF00156-00158
MMAS,19375,38575,19200,6,38,CF00047-00424
MMAS,0,5876,5876,6,27,CF00198-00463
MMAS,0,5876,5876,6,29,CF00046-00423
MAB,14354,36752,22398,6,34,CF00053-00404
MAV,0,20721,20721,6,52,CF00188-00371
MAB,15233,33217,17984,6,29,CF00040-00180
MAB,26655,35159,8504,6,29,CF00795-00699
MAB,0,12973,12973,6,49,CF00261-00765
MCHIM,7994,34478,26484,6,57,CF00187-00369
MCHIM,204,26688,26484,6,54,CF00129-00133
MAB,14511,31654,17143,6,46,CF00039-00415
MAV,2779,21091,18312,6,51,CF00128-00132
MAB,644,21425,20781,6,34,CF00134-00138
MINT,4463,21089,16626,6,58,CF00059-00445
MCHIM,0,25267,25267,6,58,CF00155-00157
MAB,0,10274,10274,6,31,CF00040-00180
MMAS,14157,31529,17372,6,31,CF00035-00411
MAV,0,18127,18127,6,55,CF00776-00667
MAV,0,18146,18146,6,52,CF00002-00012
MBOL,0,16069,16069,6,34,CF00020-00045
MAB,9717,22383,12666,6,35,CF00167-00168
MAV,0,17060,17060,6,57,CF00164-00165
MCHIM,7297,24906,17609,6,67,CF00129-00133
MCHIM,3360,22827,19467,6,69,CF00194-00380
MAV,9313,27350,18037,6,62,CF00168-00169
MAV,0,10816,10816,6,61,CF00779-00669
MAV,4357,22997,18640,6,59,CF00095-00100
MAB,14511,25870,11359,6,58,CF00261-00765
MAV,0,16411,16411,6,55,CF00189-00372
MAV,9301,25747,16446,6,59,CF00164-00165
MAB,13377,22622,9245,6,38,CF00107-00704
MAB,19197,25583,6386,6,60,CF00261-00765
MAV,9296,25128,15832,6,63,CF00019-00043
MAB,14896,24615,9719,6,44,CF00038-00414
MMAS,14896,24615,9719,6,25,CF00001-00005
MAB,14896,24615,9719,6,53,CF00141-00144
MAB,14896,24615,9719,6,62,CF00261-00765
MMAS,14896,24615,9719,6,24,CF00024-00056
MAB,14896,24615,9719,6,39,CF00167-00168
MAB,14896,24615,9719,6,50,CF00064-00439
MAB,14890,24608,9718,6,25,CF00308-00653
MAB,14889,24607,9718,6,36,CF00208-00451
MAB,14889,24607,9718,6,33,CF00118-00122
MAB,1887,18844,16957,6,64,CF00786-00686
MAB,14896,24563,9667,6,45,CF00013-00035
MMAS,1944,15692,13748,6,37,CF00035-00411
MAV,9320,24368,15048,6,70,CF00022-00049
MAV,0,15020,15020,6,69,CF00100-00195
MAB,14352,23485,9133,6,40,CF00068-00219
MAB,14352,23485,9133,6,35,CF00280-00677
MAB,3301,21342,18041,6,33,CF00783-00676
MAV,9330,22953,13623,6,64,CF00188-00371
MAV,0,13532,13532,6,65,CF00111-00115
MAV,9879,21735,11856,6,59,CF00060-00174
MMAS,0,11918,11918,6,37,CF00053-00403
MAB,6065,21864,15799,6,32,CF00211-00454
MAV,9880,21700,11820,6,63,CF00008-00396
MAV,12,11832,11820,6,61,CF00189-00372
MAV,9879,20853,10974,6,64,CF00164-00165
MAV,4196,13591,9395,6,81,CF00052-00071
MMAS,8733,20445,11712,6,34,CF00154-00213
MMAS,0,11663,11663,6,39,CF00053-00403
MAB,1542,14002,12460,6,32,CF00040-00180
MAB,1542,14002,12460,6,37,CF00016-00037
MAB,1542,14002,12460,6,53,CF00031-00407
MAB,1542,14002,12460,6,55,CF00037-00413
MAB,6108,18568,12460,6,44,CF00151-00153
MAB,1542,14002,12460,6,47,CF00050-00429
MAB,1542,14002,12460,6,70,CF00261-00765
MAB,6108,18568,12460,6,48,CF00013-00035
MAB,1542,14002,12460,6,51,CF00030-00406
MAB,1542,13990,12448,6,38,CF00076-00179
MAB,14656,19773,5117,6,40,CF00106-00110
MAB,5903,19889,13986,6,41,CF00116-00120
MAV,5522,19713,14191,6,82,CF00062-00447
MAV,4322,16903,12581,6,60,CF00198-00657
MAV,4355,16984,12629,6,77,CF00058-00099
MAV,11120,18768,7648,6,79,CF00168-00169
MAB,4166,14750,10584,6,45,CF00167-00168
MAB,1202,14895,13693,6,47,CF00038-00414
MAB,0,12854,12854,6,34,CF00209-00452
MAB,3516,18166,14650,6,43,CF00093-00098
MAB,1622,14072,12450,6,47,CF00152-00154
MAB,3993,16443,12450,6,47,CF00017-00040
MAB,1622,14072,12450,6,50,CF00108-00112
MAB,1622,14072,12450,6,44,CF00045-00421
MAB,3993,16443,12450,6,48,CF00032-00408
MAB,1622,14072,12450,6,45,CF00123-00127
MAB,3993,16443,12450,6,47,CF00764-00646
MAV,1009,13638,12629,6,103,CF00075-00224
MCHIM,7297,17929,10632,6,88,CF00194-00380
MCHIM,0,10618,10618,6,90,CF00187-00369
MCHIM,5214,16883,11669,6,91,CF00187-00369
MAV,0,11809,11809,6,82,CF00027-00066
MAV,2184,13814,11630,6,93,CF00124-00128
MAB,5905,14946,9041,6,45,CF00026-00061
MAV,2658,13935,11277,6,92,CF00022-00049
MAV,0,11001,11001,6,71,CF00198-00657
MAB,6816,13661,6845,6,52,CF00038-00414
MAV,856,10348,9492,6,89,CF00358-01030
MCHIM,2234,8774,6540,6,95,CF00155-00157
MAV,4709,10640,5931,6,93,CF00060-00174
MAV,5086,12195,7109,6,116,CF00012-00435
MAV,2933,10892,7959,6,98,CF00168-00169
MAV,114,8073,7959,6,100,CF00057-00443
MAV,2934,10845,7911,6,108,CF00150-00152
MAV,3067,10286,7219,6,127,CF00012-00435
MMAS,0,5965,5965,6,57,CF00121-00125
MAB,0,27461,27461,1,33,CF00125-00129
MAB,0,27297,27297,1,39,CF00055-00431
MAB,0,27296,27296,1,35,CF00142-00145
MAB,0,27294,27294,1,34,CF00041-00417
MAB,0,27291,27291,1,35,CF00144-00147
MAB,0,27283,27283,1,36,CF00067-00436
MAB,0,27281,27281,1,36,CF00065-00440
MAB,0,27273,27273,1,39,CF00158-00160
MAB,0,25643,25643,1,37,CF00116-00120
MAB,0,25034,25034,1,36,CF00093-00098
MAB,0,25023,25023,1,28,CF00114-00118
MAB,0,24607,24607,1,36,CF00041-00417
MAB,0,24459,24459,1,37,CF00208-00451
MAB,0,23289,23289,1,36,CF00157-00159
MAB,0,22934,22934,1,34,CF00120-00124
MAB,0,18477,18477,1,33,CF00143-00146
MAB,0,17941,17941,1,37,CF00314-00660
MAB,0,17912,17912,1,33,CF00211-00454
MAB,0,17858,17858,1,42,CF00026-00061
MAB,0,11829,11829,1,56,CF00108-00112
MAB,0,11303,11303,1,133,CF00786-00686
MAB,0,10926,10926,1,47,CF00026-00061
MAV,0,8540,8540,1,79,CF00198-00657
MAB,0,3243,3243,1,254,CF00786-00686
MAB,0,3154,3154,1,258,CF00786-00686
MAB,0,137402,137402,2,15,CF00076-00179
MAB,0,115702,115702,2,17,CF00064-00439
MAB,0,74801,74801,2,23,CF00026-00061
MAB,0,66309,66309,2,29,CF00041-00417
MAB,0,66115,66115,2,24,CF00171-00172
MAB,0,66115,66115,2,23,CF00211-00454
MAB,0,57585,57585,2,30,CF00144-00147
MAB,0,57417,57417,2,29,CF00788-00688
MAV,0,57270,57270,2,30,CF00776-00667
MAB,0,55532,55532,2,27,CF00135-00139
MAB,0,55470,55470,2,32,CF00090-00095
MAB,0,54835,54835,2,29,CF00026-00061
MBOL,0,52855,52855,2,30,CF00020-00045
MMAS,0,52603,52603,2,32,CF00054-00430
MAB,0,52041,52041,2,30,CF00065-00440
MMAS,0,47585,47585,2,21,CF00024-00056
MAB,0,44359,44359,2,36,CF00017-00040
MAB,0,40031,40031,2,31,CF00142-00145
MAB,0,38336,38336,2,32,CF00096-00101
MMAS,0,37465,37465,2,29,CF00316-00499
MAV,0,36833,36833,2,51,CF00062-00447
MAB,0,35847,35847,2,36,CF00154-00156
MAB,0,35845,35845,2,35,CF00053-00404
MAB,0,33765,33765,2,30,CF00171-00172
MAB,0,32700,32700,2,36,CF00034-00410
MAB,0,32541,32541,2,35,CF00134-00138
MAB,0,32023,32023,2,36,CF00055-00431
MAB,0,30329,30329,2,30,CF00795-00699
MAB,0,30175,30175,2,36,CF00134-00138
MMAS,0,27679,27679,2,26,CF00193-00178
MAB,0,26237,26237,2,33,CF00135-00139
MBOL,0,25150,25150,2,38,CF00773-00659
MAB,0,22946,22946,2,43,CF00055-00431
MAB,0,21397,21397,2,72,CF00786-00686
MMAS,0,20397,20397,2,57,CF00047-00424
MAB,0,20226,20226,2,75,CF00786-00686
MAB,0,19774,19774,2,37,CF00120-00124
MAB,0,19742,19742,2,35,CF00023-00438
MAV,0,19397,19397,2,76,CF00188-00371
MAB,0,16817,16817,2,49,CF00123-00127
MAB,0,16782,16782,2,53,CF00108-00112
MAB,0,16597,16597,2,94,CF00786-00686
MAB,0,16412,16412,2,44,CF00067-00436
MAB,0,16411,16411,2,42,CF00125-00129
MAB,0,16411,16411,2,45,CF00065-00440
MAB,0,16408,16408,2,49,CF00055-00431
MAB,0,16406,16406,2,34,CF00114-00118
MAB,0,16401,16401,2,45,CF00158-00160
MAB,0,16381,16381,2,46,CF00093-00098
MAB,0,16359,16359,2,46,CF00160-00161
MAB,0,15826,15826,2,34,CF00143-00146
MAV,0,15792,15792,2,103,CF00008-00396
MAB,0,15782,15782,2,33,CF00080-00085
MAB,0,15731,15731,2,38,CF00006-00020
MAB,0,15726,15726,2,44,CF00066-00705
MAB,0,15726,15726,2,39,CF00048-00425
MAB,0,15725,15725,2,42,CF00148-00210
MAB,0,15725,15725,2,49,CF00097-00102
MAB,0,15723,15723,2,47,CF00053-00404
MAB,0,15709,15709,2,47,CF00154-00156
MAB,0,15700,15700,2,49,CF00090-00095
MAB,0,15691,15691,2,34,CF00211-00454
MAB,0,15683,15683,2,101,CF00786-00686
MAB,0,15415,15415,2,40,CF00134-00138
MAB,0,14791,14791,2,40,CF00023-00438
MAB,0,14695,14695,2,40,CF00144-00147
MMAS,0,14601,14601,2,40,CF00766-00648
MAB,0,13775,13775,2,48,CF00116-00120
MAB,0,13512,13512,2,53,CF00032-00408
MMAS,0,12265,12265,2,45,CF00035-00411
MAB,0,12190,12190,2,43,CF00134-00138
MMAS,0,10911,10911,2,36,CF00091-00096
MAB,0,10440,10440,2,45,CF00134-00138
MAV,0,9137,9137,2,126,CF00062-00447
MMAS,0,9127,9127,2,52,CF00148-00208
MAB,0,8828,8828,2,160,CF00786-00686
MAV,0,8823,8823,2,103,CF00776-00667
MMAS,0,8321,8321,2,48,CF00053-00403
MMAS,0,8161,8161,2,42,CF00042-00418
MAV,0,7745,7745,2,81,CF00198-00657
MAB,0,7538,7538,2,49,CF00026-00061
MAB,0,7263,7263,2,48,CF00066-00705
MAB,0,6966,6966,2,178,CF00786-00686
MAV,0,6617,6617,2,103,CF00100-00195
MAV,0,6617,6617,2,102,CF00027-00066
MMAS,0,6612,6612,2,52,CF00046-00423
MMAS,0,6514,6514,2,43,CF00042-00418
MAB,0,6161,6161,2,53,CF00116-00120
MAB,0,5646,5646,2,54,CF00116-00120
MAB,0,5383,5383,2,197,CF00786-00686
MAV,0,5194,5194,2,263,CF00008-00396
MMAS,0,5175,5175,2,84,CF00056-00432
MMAS,0,5130,5130,2,59,CF00121-00125
MMAS,0,5084,5084,2,37,CF00316-00499
MAB,0,5023,5023,2,50,CF00066-00705
MCHIM,0,4941,4941,2,105,CF00112-01031
MAB,0,4905,4905,2,204,CF00786-00686
MAV,0,4884,4884,2,187,CF00075-00224
MAV,0,4881,4881,2,156,CF00012-00435
MMAS,0,4775,4775,2,60,CF00121-00125
MAB,0,4612,4612,2,49,CF00023-00438
MAV,0,4546,4546,2,114,CF00111-00115
MAB,0,4423,4423,2,216,CF00786-00686
MAB,0,4338,4338,2,218,CF00786-00686
MMAS,0,3822,3822,2,38,CF00091-00096
MCHIM,0,3730,3730,2,129,CF00070-00220
MAV,0,3691,3691,2,306,CF00008-00396
MAB,0,3584,3584,2,237,CF00786-00686
MAV,0,3034,3034,2,111,CF00027-00066
MAV,0,3034,3034,2,126,CF00100-00195
MAV,0,3034,3034,2,85,CF00083-00088
MAB,0,2846,2846,2,52,CF00023-00438
MAB,0,2841,2841,2,53,CF00023-00438
MAB,0,2652,2652,2,278,CF00786-00686
MAV,0,2148,2148,2,124,CF00095-00100
MAB,0,2097,2097,2,291,CF00786-00686
MAB,0,1868,1868,2,57,CF00023-00438
MAB,0,1865,1865,2,58,CF00023-00438
MAV,0,1378,1378,2,106,CF00002-00012
MAV,0,1378,1378,2,132,CF00776-00667
MAV,0,1376,1376,2,137,CF00111-00115
MAV,0,1376,1376,2,135,CF00060-00174
MAV,0,1376,1376,2,163,CF00028-00067
MAV,0,1376,1376,2,137,CF00358-01030
MAV,0,1376,1376,2,128,CF00164-00165
MAV,0,1376,1376,2,147,CF00168-00169
MAV,0,1374,1374,2,169,CF00193-00177
MCHIM,0,1354,1354,2,139,CF00112-01031
MCHIM,0,1354,1354,2,108,CF00115-00119
MCHIM,0,1354,1354,2,155,CF00060-00446
MCHIM,0,1354,1354,2,160,CF00155-00157
MCHIM,0,1354,1354,2,173,CF00194-00380
MCHIM,0,1354,1354,2,182,CF00187-00369
MCHIM,0,1354,1354,2,187,CF00129-00133
MCHIM,0,1354,1354,2,152,CF00070-00220
MCHIM,0,1351,1351,2,109,CF00115-00119
MCHIM,0,1351,1351,2,161,CF00155-00157
MCHIM,0,1351,1351,2,153,CF00070-00220
MCHIM,0,1351,1351,2,140,CF00112-01031
MCHIM,0,1350,1350,2,157,CF00060-00446
MCHIM,0,1350,1350,2,183,CF00187-00369
MCHIM,0,1350,1350,2,188,CF00129-00133
MAV,0,1350,1350,2,155,CF00188-00371
MCHIM,0,1350,1350,2,174,CF00194-00380
MAV,0,1348,1348,2,442,CF00008-00396
MAV,0,1347,1347,2,166,CF00052-00071
MAV,0,1347,1347,2,104,CF00198-00657
MAV,0,1347,1347,2,163,CF00779-00669
MAV,0,1347,1347,2,144,CF00100-00195
MAV,0,1347,1347,2,252,CF00075-00224
MAV,0,1347,1347,2,159,CF00022-00049
MAV,0,1347,1347,2,175,CF00063-00448
MAV,0,1347,1347,2,251,CF00075-00224
MAV,0,1347,1347,2,160,CF00022-00049
MAV,0,1347,1347,2,103,CF00198-00657
MMAS,0,1344,1344,2,43,CF00316-00499
MINT,0,1312,1312,2,106,CF00073-00222
MINT,0,1312,1312,2,75,CF00145-00148
MINT,0,1311,1311,2,108,CF00074-00223
MINT,0,1311,1311,2,86,CF00131-00203
MINT,0,1311,1311,2,128,CF00092-00097
MINT,0,1311,1311,2,74,CF00079-00228
MAV,0,1299,1299,2,148,CF00057-00443
MAV,0,1275,1275,2,169,CF00189-00372
MCHIM,0,1271,1271,2,159,CF00060-00446
MCHIM,0,1271,1271,2,140,CF00770-00654
MAV,0,1270,1270,2,150,CF00168-00169
MAV,0,1270,1270,2,141,CF00358-01030
MAV,0,1269,1269,2,159,CF00026-00062
MAV,0,1268,1268,2,165,CF00028-00067
MAV,0,1268,1268,2,164,CF00779-00669
MAV,0,1267,1267,2,168,CF00011-00054
MAV,0,1267,1267,2,151,CF00168-00169
MAV,0,1267,1267,2,151,CF00058-00099
MAV,0,1267,1267,2,161,CF00150-00152
MAV,0,1267,1267,2,170,CF00189-00372
MAV,0,1267,1267,2,138,CF00060-00174
MAV,0,1267,1267,2,129,CF00164-00165
MAV,0,1267,1267,2,166,CF00028-00067
MAV,0,1267,1267,2,139,CF00111-00115
MAV,0,1267,1267,2,452,CF00008-00396
MAV,0,1267,1267,2,107,CF00002-00012
MAV,0,1267,1267,2,149,CF00057-00443
MAV,0,1266,1266,2,142,CF00358-01030
MAV,0,1266,1266,2,160,CF00026-00062
MAV,0,1266,1266,2,172,CF00163-00164
MAB,0,1265,1265,2,62,CF00032-00408
MAB,0,1265,1265,2,61,CF00013-00035
MMAS,0,1265,1265,2,51,CF00054-00430
MAB,0,1265,1265,2,56,CF00045-00421
MAB,0,1265,1265,2,71,CF00037-00413
MMAS,0,1265,1265,2,59,CF00148-00208
MBOL,0,1265,1265,2,34,CF00113-00117
MAB,0,1265,1265,2,68,CF00764-00646
MAB,0,1265,1265,2,71,CF00031-00407
MAB,0,1265,1265,2,65,CF00123-00127
MAB,0,1265,1265,2,71,CF00050-00429
MAB,0,1265,1265,2,63,CF00167-00168
MAB,0,1265,1265,2,65,CF00108-00112
MAB,0,1265,1265,2,93,CF00141-00144
MAB,0,1265,1265,2,85,CF00297-01032
MAB,0,1265,1265,2,66,CF00123-00127
MAB,0,1265,1265,2,66,CF00030-00406
MAB,0,1265,1265,2,66,CF00152-00154
MAB,0,981,981,2,353,CF00786-00686
MAB,0,793,793,2,386,CF00786-00686
MAB,0,119844,119844,3,16,CF00030-00406
MAV,0,110748,110748,3,17,CF00127-00131
MAB,0,103579,103579,3,20,CF00118-00122
MAB,0,103526,103526,3,22,CF00034-00410
MAB,0,98977,98977,3,20,CF00065-00440
MAB,0,94490,94490,3,21,CF00297-01032
MAB,0,89449,89449,3,20,CF00160-00161
MAB,0,86182,86182,3,22,CF00795-00699
MMAS,0,85741,85741,3,20,CF00156-00158
MMAS,0,85741,85741,3,19,CF00047-00424
MAV,0,83554,83554,3,21,CF00012-00435
MAB,0,81192,81192,3,23,CF00144-00147
MAB,0,81173,81173,3,23,CF00158-00160
MAB,0,81170,81170,3,22,CF00055-00431
MAB,0,79873,79873,3,25,CF00152-00154
MAB,0,77970,77970,3,22,CF00097-00102
MAV,0,75768,75768,3,19,CF00188-00371
MAB,0,75062,75062,3,25,CF00067-00436
MAV,0,75003,75003,3,25,CF00166-00167
MAV,0,71936,71936,3,28,CF00111-00115
MCHIM,0,66332,66332,3,35,CF00194-00380
MINT,0,64088,64088,3,37,CF00078-00227
MAV,0,64064,64064,3,32,CF00062-00447
MAB,0,62052,62052,3,29,CF00141-00144
MAV,0,58957,58957,3,33,CF00193-00177
MMAS,0,57723,57723,3,25,CF00046-00423
MAV,0,56041,56041,3,36,CF00127-00131
MAB,0,55023,55023,3,32,CF00039-00415
MCHIM,0,54993,54993,3,37,CF00129-00133
MAV,0,54802,54802,3,32,CF00117-00121
MAB,0,53580,53580,3,32,CF00064-00439
MAV,0,53294,53294,3,38,CF00358-01030
MBOL,0,50518,50518,3,22,CF00113-00117
MAV,0,50090,50090,3,38,CF00111-00115
MAV,0,49225,49225,3,39,CF00117-00121
MAB,0,48715,48715,3,36,CF00141-00144
MAV,0,47935,47935,3,39,CF00052-00071
MAB,0,46497,46497,3,32,CF00151-00153
MCHIM,0,46149,46149,3,44,CF00112-01031
MAV,0,45826,45826,3,47,CF00012-00435
MAV,0,45498,45498,3,40,CF00062-00447
MAB,0,44113,44113,3,35,CF00064-00439
MINT,0,43567,43567,3,47,CF00078-00227
MCHIM,0,43499,43499,3,49,CF00129-00133
MCHIM,0,43488,43488,3,44,CF00155-00157
MAV,0,43280,43280,3,48,CF00012-00435
MAV,0,42916,42916,3,43,CF00358-01030
MAV,0,42529,42529,3,42,CF00052-00071
MAB,0,41741,41741,3,33,CF00167-00168
MCHIM,0,41519,41519,3,51,CF00194-00380
MAB,0,40582,40582,3,31,CF00134-00138
MAV,0,40412,40412,3,41,CF00189-00372
MAB,0,40237,40237,3,41,CF00039-00415
MCHIM,0,39883,39883,3,52,CF00187-00369
MCHIM,0,39883,39883,3,50,CF00129-00133
MMAS,0,39696,39696,3,32,CF00082-00087
MAV,0,39359,39359,3,44,CF00127-00131
MAV,0,39168,39168,3,49,CF00168-00169
MCHIM,0,38742,38742,3,49,CF00155-00157
MAV,0,37737,37737,3,47,CF00358-01030
MAV,0,37628,37628,3,49,CF00062-00447
MAV,0,37331,37331,3,49,CF00358-01030
MAB,0,36858,36858,3,35,CF00055-00431
MAV,0,36613,36613,3,48,CF00128-00132
MAB,0,36610,36610,3,47,CF00261-00765
MAV,0,36424,36424,3,47,CF00111-00115
MMAS,0,36167,36167,3,41,CF00047-00424
MAV,0,35975,35975,3,50,CF00146-00149
MAV,0,35373,35373,3,48,CF00166-00167
MAV,0,35130,35130,3,44,CF00083-00088
MAV,0,34940,34940,3,59,CF00012-00435
MAB,0,34483,34483,3,40,CF00097-00102
MCHIM,0,34349,34349,3,55,CF00194-00380
MAB,0,34091,34091,3,44,CF00030-00406
MCHIM,0,33868,33868,3,54,CF00070-00220
MAB,0,33583,33583,3,44,CF00297-01032
MAV,0,33362,33362,3,52,CF00128-00132
MCHIM,0,33182,33182,3,57,CF00129-00133
MCHIM,0,33182,33182,3,61,CF00187-00369
MAV,0,32845,32845,3,54,CF00358-01030
MAB,0,32763,32763,3,38,CF00151-00153
MAV,0,32585,32585,3,49,CF00117-00121
MINT,0,32117,32117,3,50,CF00012-00032
MBOL,0,31725,31725,3,28,CF00113-00117
MAB,0,31413,31413,3,42,CF00152-00154
MAV,0,31412,31412,3,53,CF00063-00448
MAB,0,30963,30963,3,42,CF00013-00035
MAB,0,30729,30729,3,25,CF00103-00108
MAV,0,30693,30693,3,55,CF00127-00131
MAB,0,30646,30646,3,37,CF00055-00431
MAV,0,30428,30428,3,47,CF00141-00206
MAV,0,30373,30373,3,49,CF00778-00668
MCHIM,0,29562,29562,3,63,CF00194-00380
MCHIM,0,29433,29433,3,64,CF00194-00380
MCHIM,0,29426,29426,3,68,CF00187-00369
MAB,0,28741,28741,3,48,CF00064-00439
MCHIM,0,28641,28641,3,66,CF00194-00380
MCHIM,0,28641,28641,3,69,CF00187-00369
MAV,0,28501,28501,3,58,CF00075-00224
MAV,0,28385,28385,3,56,CF00095-00100
MAV,0,28201,28201,3,64,CF00110-00114
MAV,0,28201,28201,3,60,CF00027-00066
MAV,0,28200,28200,3,63,CF00100-00195
MAB,0,27963,27963,3,37,CF00134-00138
MMAS,0,27647,27647,3,34,CF00035-00411
MAV,0,27022,27022,3,61,CF00358-01030
MAV,0,26945,26945,3,77,CF00012-00435
MAB,0,26194,26194,3,50,CF00039-00415
MAV,0,25869,25869,3,64,CF00779-00669
MMAS,0,25809,25809,3,32,CF00766-00648
MAB,0,25800,25800,3,42,CF00017-00040
MMAS,0,25697,25697,3,36,CF00035-00411
MAB,0,25439,25439,3,34,CF00076-00179
MAB,0,25334,25334,3,37,CF00106-00110
MINT,0,24611,24611,3,61,CF00132-00136
MINT,0,24606,24606,3,59,CF00004-00018
MCHIM,0,24603,24603,3,74,CF00129-00133
MCHIM,0,24560,24560,3,74,CF00187-00369
MCHIM,0,24428,24428,3,67,CF00070-00220
MCHIM,0,24352,24352,3,76,CF00129-00133
MAB,0,24349,24349,3,40,CF00167-00168
MAB,0,24234,24234,3,49,CF00030-00406
MAB,0,23905,23905,3,38,CF00093-00098
MMAS,0,23886,23886,3,53,CF00047-00424
MMAS,0,23803,23803,3,30,CF00156-00158
MBOL,0,23734,23734,3,39,CF00773-00659
MCHIM,0,23702,23702,3,77,CF00129-00133
MCHIM,0,23686,23686,3,71,CF00070-00220
MCHIM,0,23684,23684,3,68,CF00770-00654
MCHIM,0,23600,23600,3,77,CF00187-00369
MMAS,0,23473,23473,3,35,CF00766-00648
MAV,0,23432,23432,3,65,CF00778-00668
MAB,0,23219,23219,3,55,CF00141-00144
MAV,0,23198,23198,3,72,CF00052-00071
MAB,0,23149,23149,3,35,CF00135-00139
MAB,0,22487,22487,3,44,CF00108-00112
MAV,0,22443,22443,3,75,CF00063-00448
MAB,0,22148,22148,3,39,CF00045-00421
MCHIM,0,21999,21999,3,80,CF00129-00133
MCHIM,0,21983,21983,3,80,CF00187-00369
MAV,0,21968,21968,3,67,CF00188-00371
MCHIM,0,21888,21888,3,70,CF00770-00654
MAV,0,21882,21882,3,54,CF00141-00206
MINT,0,21881,21881,3,53,CF00079-00228
MAV,0,21876,21876,3,75,CF00075-00224
MAB,0,21287,21287,3,65,CF00261-00765
MAV,0,21229,21229,3,90,CF00012-00435
MCHIM,0,21213,21213,3,66,CF00112-01031
MCHIM,0,21203,21203,3,76,CF00070-00220
MAV,0,21148,21148,3,82,CF00075-00224
MAV,0,21146,21146,3,70,CF00058-00099
MAV,0,21136,21136,3,77,CF00052-00071
MAB,0,21050,21050,3,53,CF00039-00415
MAB,0,20476,20476,3,69,CF00261-00765
MAV,0,20233,20233,3,57,CF00083-00088
MAV,0,20182,20182,3,72,CF00008-00396
MAV,0,20135,20135,3,75,CF00100-00195
MAV,0,19921,19921,3,87,CF00146-00149
MAV,0,19908,19908,3,75,CF00124-00128
MAV,0,19764,19764,3,59,CF00198-00657
MAV,0,19761,19761,3,80,CF00062-00447
MINT,0,19457,19457,3,68,CF00004-00018
MAV,0,19353,19353,3,83,CF00063-00448
MAB,0,19248,19248,3,44,CF00167-00168
MAV,0,19194,19194,3,74,CF00127-00131
MINT,0,19157,19157,3,64,CF00012-00032
MCHIM,0,18891,18891,3,79,CF00060-00446
MMAS,0,18671,18671,3,45,CF00082-00087
MAB,0,18611,18611,3,52,CF00297-01032
MAB,0,18611,18611,3,60,CF00141-00144
MMAS,0,18589,18589,3,46,CF00082-00087
MAB,0,18514,18514,3,47,CF00167-00168
MAB,0,18506,18506,3,49,CF00108-00112
MAB,0,18504,18504,3,43,CF00045-00421
MAB,0,18503,18503,3,43,CF00123-00127
MAB,0,18502,18502,3,38,CF00096-00101
MAV,0,18364,18364,3,75,CF00026-00062
MAV,0,18304,18304,3,84,CF00008-00396
MAV,0,18303,18303,3,84,CF00150-00152
MAV,0,18302,18302,3,74,CF00164-00165
MAV,0,18302,18302,3,84,CF00168-00169
MAV,0,18302,18302,3,74,CF00060-00174
MAV,0,18301,18301,3,78,CF00028-00067
MAV,0,18294,18294,3,100,CF00075-00224
MAV,0,18292,18292,3,77,CF00111-00115
MAV,0,18288,18288,3,87,CF00062-00447
MAV,0,18285,18285,3,80,CF00011-00054
MAV,0,18285,18285,3,70,CF00193-00177
MAV,0,18275,18275,3,78,CF00111-00115
MAV,0,18199,18199,3,87,CF00063-00448
MAV,0,18185,18185,3,98,CF00012-00435
MAV,0,18164,18164,3,81,CF00058-00099
MAB,0,18117,18117,3,47,CF00097-00102
MAB,0,18117,18117,3,31,CF00114-00118
MAB,0,18117,18117,3,41,CF00157-00159
MAV,0,18044,18044,3,83,CF00358-01030
MAB,0,18006,18006,3,56,CF00039-00415
MAB,0,17995,17995,3,42,CF00106-00110
MAV,0,17984,17984,3,76,CF00778-00668
MAV,0,17877,17877,3,79,CF00779-00669
MAB,0,17834,17834,3,52,CF00030-00406
MAB,0,17783,17783,3,89,CF00786-00686
MAV,0,17584,17584,3,78,CF00189-00372
MAB,0,17186,17186,3,32,CF00114-00118
MCHIM,0,17126,17126,3,84,CF00070-00220
MAB,0,17041,17041,3,41,CF00130-00134
MMAS,0,17035,17035,3,33,CF00316-00499
MAV,0,17025,17025,3,78,CF00095-00100
MCHIM,0,17018,17018,3,89,CF00194-00380
MCHIM,0,16945,16945,3,90,CF00194-00380
MCHIM,0,16828,16828,3,93,CF00187-00369
MAB,0,16765,16765,3,44,CF00065-00440
MCHIM,0,16763,16763,3,94,CF00187-00369
MCHIM,0,16763,16763,3,92,CF00129-00133
MCHIM,0,16724,16724,3,82,CF00060-00446
MAB,0,16685,16685,3,50,CF00152-00154
MCHIM,0,16587,16587,3,96,CF00187-00369
MCHIM,0,16524,16524,3,97,CF00187-00369
MCHIM,0,16524,16524,3,95,CF00129-00133
MAB,0,16462,16462,3,55,CF00297-01032
MAB,0,16353,16353,3,37,CF00006-00020
MAV,0,16295,16295,3,82,CF00019-00043
MAV,0,16226,16226,3,94,CF00063-00448
MMAS,0,16224,16224,3,29,CF00193-00178
MMAS,0,16224,16224,3,34,CF00316-00499
MMAS,0,16223,16223,3,37,CF00042-00418
MAV,0,16209,16209,3,86,CF00058-00099
MAV,0,16007,16007,3,87,CF00124-00128
MCHIM,0,16006,16006,3,86,CF00060-00446
MAB,0,15979,15979,3,65,CF00141-00144
MCHIM,0,15744,15744,3,87,CF00070-00220
MAV,0,15727,15727,3,96,CF00063-00448
MINT,0,15726,15726,3,80,CF00092-00097
MAV,0,15541,15541,3,117,CF00075-00224
MAB,0,15390,15390,3,49,CF00038-00414
MAV,0,15356,15356,3,86,CF00188-00371
MCHIM,0,15305,15305,3,79,CF00112-01031
MMAS,0,15238,15238,3,39,CF00766-00648
MAV,0,15218,15218,3,119,CF00075-00224
MAV,0,15082,15082,3,89,CF00189-00372
MAV,0,15062,15062,3,104,CF00146-00149
MAB,0,15043,15043,3,54,CF00030-00406
MAV,0,14973,14973,3,89,CF00022-00049
MAV,0,14835,14835,3,99,CF00052-00071
MAV,0,14827,14827,3,125,CF00075-00224
MAV,0,14782,14782,3,84,CF00778-00668
MCHIM,0,14677,14677,3,99,CF00194-00380
MCHIM,0,14662,14662,3,92,CF00060-00446
MAB,0,14637,14637,3,49,CF00167-00168
MAV,0,14575,14575,3,94,CF00150-00152
MCHIM,0,14452,14452,3,80,CF00112-01031
MCHIM,0,14387,14387,3,100,CF00194-00380
MCHIM,0,14386,14386,3,101,CF00129-00133
MAV,0,14285,14285,3,94,CF00011-00054
MINT,0,14251,14251,3,73,CF00132-00136
MAV,0,14232,14232,3,86,CF00776-00667
MAV,0,14226,14226,3,112,CF00008-00396
MCHIM,0,14213,14213,3,105,CF00187-00369
MAV,0,13981,13981,3,87,CF00111-00115
MAB,0,13965,13965,3,69,CF00141-00144
MAB,0,13933,13933,3,78,CF00261-00765
MAV,0,13909,13909,3,87,CF00026-00062
MAB,0,13903,13903,3,57,CF00297-01032
MCHIM,0,13879,13879,3,107,CF00129-00133
MCHIM,0,13879,13879,3,107,CF00194-00380
MMAS,0,13855,13855,3,67,CF00047-00424
MAV,0,13842,13842,3,96,CF00150-00152
MAB,0,13745,13745,3,36,CF00080-00085
MAV,0,13630,13630,3,92,CF00058-00099
MAV,0,13584,13584,3,90,CF00358-01030
MAV,0,13515,13515,3,129,CF00075-00224
MAB,0,13465,13465,3,52,CF00167-00168
MCHIM,0,13458,13458,3,87,CF00770-00654
MCHIM,0,13458,13458,3,99,CF00060-00446
MCHIM,0,13458,13458,3,94,CF00070-00220
MCHIM,0,13458,13458,3,110,CF00129-00133
MCHIM,0,13458,13458,3,67,CF00115-00119
MCHIM,0,13458,13458,3,110,CF00194-00380
MCHIM,0,13458,13458,3,111,CF00187-00369
MAV,0,13373,13373,3,91,CF00358-01030
MAV,0,13355,13355,3,87,CF00778-00668
MAB,0,13294,13294,3,59,CF00031-00407
MAB,0,13284,13284,3,42,CF00280-00677
MAV,0,13246,13246,3,95,CF00188-00371
MAV,0,13240,13240,3,98,CF00110-00114
MAB,0,13215,13215,3,60,CF00039-00415
MMAS,0,13107,13107,3,35,CF00156-00158
MAB,0,13092,13092,3,53,CF00050-00429
MAV,0,12956,12956,3,114,CF00012-00435
MAV,0,12786,12786,3,94,CF00022-00049
MAB,0,12688,12688,3,59,CF00297-01032
MAV,0,12633,12633,3,78,CF00002-00012
MAV,0,12498,12498,3,91,CF00028-00067
MMAS,0,12482,12482,3,78,CF00056-00432
MAB,0,12398,12398,3,60,CF00297-01032
MAB,0,12220,12220,3,72,CF00141-00144
MAV,0,12111,12111,3,90,CF00019-00043
MAV,0,12024,12024,3,95,CF00111-00115
MAV,0,12013,12013,3,76,CF00141-00206
MAB,0,11909,11909,3,53,CF00017-00040
MAV,0,11845,11845,3,96,CF00060-00174
MAV,0,11788,11788,3,95,CF00779-00669
MAV,0,11686,11686,3,98,CF00358-01030
MAV,0,11444,11444,3,146,CF00008-00396
MAB,0,11415,11415,3,61,CF00297-01032
MAV,0,11135,11135,3,121,CF00146-00149
MCHIM,0,11088,11088,3,91,CF00112-01031
MINT,0,11066,11066,3,83,CF00078-00227
MAB,0,10959,10959,3,78,CF00141-00144
MAV,0,10818,10818,3,124,CF00012-00435
MAV,0,10750,10750,3,125,CF00146-00149
MAB,0,10730,10730,3,79,CF00141-00144
MAV,0,10490,10490,3,130,CF00146-00149
MAV,0,10415,10415,3,159,CF00008-00396
MAV,0,10300,10300,3,116,CF00124-00128
MAV,0,10150,10150,3,103,CF00779-00669
MAV,0,10094,10094,3,129,CF00012-00435
MAB,0,9739,9739,3,46,CF00134-00138
MCHIM,0,9583,9583,3,119,CF00194-00380
MAV,0,9567,9567,3,115,CF00063-00448
MAB,0,9539,9539,3,87,CF00261-00765
MINT,0,9376,9376,3,88,CF00073-00222
MMAS,0,9360,9360,3,50,CF00046-00423
MCHIM,0,9053,9053,3,122,CF00187-00369
MCHIM,0,9052,9052,3,120,CF00129-00133
MAV,0,8882,8882,3,134,CF00012-00435
MAB,0,8882,8882,3,47,CF00134-00138
MMAS,0,8775,8775,3,37,CF00198-00463
MAV,0,8760,8760,3,190,CF00008-00396
MAB,0,8635,8635,3,46,CF00106-00110
MAB,0,8421,8421,3,91,CF00261-00765
MAV,0,8032,8032,3,104,CF00128-00132
MAV,0,7935,7935,3,203,CF00008-00396
MCHIM,0,7835,7835,3,128,CF00129-00133
MCHIM,0,7835,7835,3,127,CF00194-00380
MAV,0,7758,7758,3,137,CF00012-00435
MAB,0,7690,7690,3,58,CF00055-00431
MAV,0,7576,7576,3,83,CF00141-00206
MAV,0,7548,7548,3,100,CF00778-00668
MAB,0,7454,7454,3,61,CF00050-00429
MMAS,0,7418,7418,3,35,CF00316-00499
MAV,0,7266,7266,3,107,CF00128-00132
MAB,0,7230,7230,3,174,CF00786-00686
MAB,0,7228,7228,3,175,CF00786-00686
MAV,0,7179,7179,3,98,CF00164-00165
MAB,0,6653,6653,3,94,CF00261-00765
MAV,0,6620,6620,3,107,CF00111-00115
MAV,0,6600,6600,3,110,CF00779-00669
MAV,0,6106,6106,3,100,CF00095-00100
MAB,0,6067,6067,3,58,CF00167-00168
MAV,0,6052,6052,3,157,CF00146-00149
MAV,0,5916,5916,3,110,CF00190-00373
MAV,0,5893,5893,3,114,CF00127-00131
MAV,0,5879,5879,3,177,CF00075-00224
MAV,0,5691,5691,3,106,CF00100-00195
MCHIM,0,5600,5600,3,125,CF00155-00157
MAB,0,5496,5496,3,52,CF00107-00704
MMAS,0,5463,5463,3,83,CF00056-00432
MAV,0,5279,5279,3,152,CF00012-00435
MAV,0,5268,5268,3,110,CF00111-00115
MAV,0,5266,5266,3,135,CF00124-00128
MAV,0,5211,5211,3,104,CF00095-00100
MCHIM,0,5022,5022,3,127,CF00060-00446
MAV,0,4916,4916,3,116,CF00058-00099
MAV,0,4916,4916,3,147,CF00062-00447
MAV,0,4881,4881,3,177,CF00146-00149
MAV,0,4823,4823,3,112,CF00100-00195
MAB,0,4801,4801,3,60,CF00108-00112
MAB,0,4788,4788,3,58,CF00032-00408
MAV,0,4738,4738,3,126,CF00028-00067
MAV,0,4711,4711,3,134,CF00011-00054
MAV,0,4684,4684,3,191,CF00075-00224
MAV,0,4646,4646,3,136,CF00063-00448
MMAS,0,4604,4604,3,86,CF00056-00432
MAB,0,4456,4456,3,215,CF00786-00686
MAV,0,4417,4417,3,129,CF00009-00029
MAV,0,4401,4401,3,118,CF00057-00443
MAV,0,4197,4197,3,107,CF00117-00121
MAB,0,4119,4119,3,55,CF00116-00120
MAV,0,3994,3994,3,129,CF00779-00669
MAV,0,3374,3374,3,177,CF00012-00435
MAV,0,3319,3319,3,212,CF00146-00149
MCHIM,0,3254,3254,3,139,CF00060-00446
MAV,0,3101,3101,3,224,CF00146-00149
MAB,0,2915,2915,3,264,CF00786-00686
MAV,0,2874,2874,3,344,CF00008-00396
MAV,0,2662,2662,3,128,CF00778-00668
MAB,0,2642,2642,3,77,CF00297-01032
MAV,0,2539,2539,3,137,CF00190-00373
MAV,0,2186,2186,3,150,CF00163-00164
MAV,0,2185,2185,3,149,CF00127-00131
MAV,0,2185,2185,3,189,CF00062-00447
MAV,0,2185,2185,3,153,CF00779-00669
MAV,0,2185,2185,3,136,CF00058-00099
MAV,0,2185,2185,3,161,CF00126-00130
MAV,0,2185,2185,3,123,CF00095-00100
MAV,0,2185,2185,3,261,CF00146-00149
MAB,0,1679,1679,3,65,CF00116-00120
MAB,0,1590,1590,3,66,CF00116-00120
MAV,0,1552,1552,3,140,CF00100-00195
MAV,0,1441,1441,3,430,CF00008-00396
MAV,0,1171,1171,3,165,CF00190-00373
MAV,0,938,938,3,167,CF00110-00114